X X X
X X X
X X X
X X X
X H X
X X X
X H X
X F F
X X X
X H X
X X X
X X X
X H X
F X F
X X X
X X X
H X X
X X X
X H X
C F F
X X X
X H X
X X X
X H X
X X X
F F J
X X X
X X H
X X X
X H X
X X X
X H F
X X X
X X X
H X X
H X X
X X X
X X H
X X H
X X X
F C F
X X X
H X X
H X X
X H X
X X X
F F X
X X X
X X X
X H X
X H X
X X X
X X H
X X H
X X H
X X H
H X X
H X X
X F F
X X X
X X X
X X X
X X X
X X X
F J F
X X X
X H X
X H X
X H X
X H X
F C X
X X X
X X X
X X X
H X X
H X X
J J H
X X X
X X X
X X X
X X X
X X X
F H F
X H X
X X X
F H F
X X X
X X X
F J F
X X X
X X H
X H X
H X X
X X X
C F F
X X X
X H X
X X H
X H X
X X X
J J F
X X X
X X X
X H X
X X X
X X H
F X X
F X H
F H X
F H X
X X X
X X X
F C F
X X F
X X F
H X X
X H X
X H X
H X X
X X F
X F F
J F F
X F F
H X X
X H X
X H X
X X X
H F H
X X X
X X X
F H X
X H X
X X X
H F F
H X X
X X X
F F H
F X H
X X X
X X X
J J J
X X X
X H X
X H F
H X F
X F F
X X X
H X H
H X H
H X H
X X X
F X F
F C F
F X F
X H X
X H X
H X H
H F H
X X X
X X X
X X F
X X F
X X X
X H X
X X X
F F X
F F X
F X X
F X H
F X H
X X X
X X X
H F X
X X X
X X X
X X X
X H X
X H X
X J J
X X X
X X X
X H X
X H X
F C F
X X F
X H F
X X X
X F H
J F J
X F X
X X X
X X X
X X X
X X X
X X X
X X X
X X X
X X X
X X X
X H X
F X X
F H X
F J X
X X X
X X X
H X F
J J F
H X F
X X F
X H X
X X X
F F H
F X X
X X X
X H X
F X X
F H X
X X F
X H F
X X F
X F F
X X F
X X X
X H X
X X X
X X H
J F J
X X X
X X X
X H X
X X X
F X F
X H X
X X X
H X X
J F J
X X X
X X H
X X X
F X X
F F H
F X X
F X X
F H X
X X F
X X F
X X X
X H X
X X X
X X X
H F F
X F F
X F F
H F F
X X F
X X F
H X F
X X X
X X H
X F X
X X X
X X X
X H X
F X F
F X F
X H X
X X X
X X X
X F X
J F C
X F X
X X X
X H X
X X X
X X X
F X F
X H X
X X X
X X X
X F X
C F J
X F X
X X X
X H X
X H X
X X X
J F F
H X X
X X X
F J F
X H X
X X X
F F J
X X H
X X X
X X X
F J F
F H F
X X X
X X X
F X F
F C F
X H X
X X X
X X X
X X X
X X X
H X H
X F X
J F J
X X X
X H X
X H X
X H X
X X X